########################################
#                 #########            #
# #############              #####     #
#  #############################       #
#  #################################   #
#  #                        e #        #
#  ##### ######################### #####
#                                      #
######### ##############################
######### ##############################
#                 #########            #
# #############              #####     #
#  #############################       #
#  #################################   #
#  #                         #         #
#  ##### ######################### #####
#                                      #
########################  ##############
######################### ##############
#                 ####### #            #
# #############              #####     #
#  #############################s      #
#  #################################   #
#  #                          #        #
#  ##### ######################### #####
#                                      #
########################################